333333333333333333333333333333333333333333333333333333333333333333333
333333333333333333333333333333333333333333333333333333333333333333333
222222221111122222222222222223333222222222222242222222222222222222222
222222221111122222222222222223333222222222222222222222222222222222222
222222221111122222222222222223333222222422222222222222222222222222222
222222222222222222222222222223333222222222222222222222222222222222222
222222222222222222222222222223333222222222222222222222222222222222222
222222222222222222222222222223333222222222111111112222222222222222222
222222222222222222222222222223333222222222111111112222222222222222222
222222221111122222112222222223333222222222111111112222222222222222222
222222222222222222112222222222222222222222222222222222222222222222222
222222222222222222222222222222222222222222222222222222222222222222222
222222222222224222222222222222222222222222221111112222222222222222222
222222222222222222222222222223333222222222221111112222222222222222222
222222222222222222222222222223333222222222221111112222222222222222222
333333333333333333322222233333333333333333333333333222223333333333333
333333333333333333322222233333333333333333333333333222223333333333333
222222221111122222222222222223333422222222222222222222222222222222222
222222221111122222222222222223333222222222222222222222222222222222222
222222221111122242222222222223333222222222222222222222222222222222222
222222222222222222222222222223333222222222222222222222222222222222222
222222222222222222222222222223333222222222222222222222222222222222222
222222221111122222222222222223333222222222111111112222222222222222222
222222221111122222222242222223333222222222111111112222222222222222222
222222221111122222222222222223333222222222111111112222222222222222222
222222222222222222222222222223333222222222222222222222222222222222222
222222222222222222222222222223333222222222222222222222222222222222222
222222221111122222222222222223333222222222221111112222222222222222222
222222221111122222222222222223333222222222221111112222222222222222222
222222221111122222222222222223333222222222221111112222222222222222222
333333333333333333333333333333333333333333333333333333333333333333333
333333333333333333333333333333333333333333333333333333333333333333333